131111111555
121122221555
121121121555
121121221555
121121211555
122121221555
112121121555
122121121555
121121121555
121121121555
122221121555
111111141555